00000000000000
00000000000000
00001100000000
00011112300000
00000110000000
00002111100000
00001221000000
00000000000000
00000000000000
00000000000000
00000000000000
00000000000000
00000000000000
00000000000000