00000000000000
02200000000220
02200111100220
00001111110000
00011122111000
00111222211100
00112233221100
00112233221100
00111222211100
00001122111000
00001111110000
02200111100220
02200000000220
00000000000000