00000000000000
00000000000000
00000000000000
00000000000000
00000000000000
00000000000000
00000000000000
00000000000000
00000010000000
00000111000000
00000111011000
00002221110000
00000320000000
00000000000000