00000000000000
00000010000000
00001110000000
00000110000000
00001111000000
00000112000000
00000222000000
00001122200000
00000322100000
00000022000000
00000020000000
00000030000000
00000010000000
00000000000000