00000000000000
00111000010000
01111100001000
00111110000000
00111110000000
00122110011000
01223220000000
00232322000000
00000232210000
00001122111000
00000111111100
00000011110010
00100011000000
00000000000000